NO ./shado.xpm
SO ./wall.xpm
WE ./med.xpm
EA ./test.xpm

F 122,157,84
C 140,192,222

        1111111111111111111111111
        1000000000110000000000001
        1011000001110000000000001
        1001000000000000000000001
111111111D11000001110000000000001
10000000001100000111D111110111111
1111D111111111011100000010001   
11110111111111011101010010001
11000000110101011100000010001
10000000000000001100W00010001
10000000000000001101010010101
110000011101010111110111000111
11110111 1110101 10111101010101
11111111 1111 1 111 111111111111
                
