NO ./texturs/1.xpm
SO ./texturs/2.xpm
WE ./texturs/3.xpm
EA ./texturs/4.xpm
DT ./texturs/door_1.xpm

F 44,36,64
C 14,27,41

        1111111111111111111111111
        1000000000110000000000001
        1011000001110000000000001
        1001000000000000000000001
111111111D11000001110000000000001
10000000001100000111D111110111111
1111D111111111011101010010001   
11110111111111011101010010001
1100000011010101110000010001
10000000000000001100W00010001
10000000000000001100010010101
110000011101010111110111000111
11110111 1110101 10111101010101
11111111 1111 1 111 111111111111
