NO ./mandatory/texturs/1.xpm
SO ./mandatory/texturs/2.xpm
WE ./mandatory/texturs/3.xpm
EA ./mandatory/texturs/4.xpm   


F 44,36,64
C 14,27,41

        1111111111111111111111111
        1000000000110000000000001
        1011000001110000000000001
        1001000000000000000000001
111111111011000001110000000000001
100000000011000001110111110111111
11110111111111011101010010001   
11110111111111011101010010001
1100000011010101110000010001
10000000000000001100W00010001
10000000000000001100010010101
110000011101010111110111000111
11110111 1110101 1011110101011
11111111 1111111 1111111111111
