NO ./mandatory/texturs/blue_light.xpm
SO ./mandatory/texturs/blue_dark.xpm
EA ./mandatory/texturs/purpel_light.xpm
WE ./mandatory/texturs/purpel_dark.xpm

F 44,36,64
C 14,27,41

11111111111111111
10000000000000011
10100010001111101
10111100001001001
10100100001001001
10100100001101111
10100000001000001
10100100000001101
10100100000001001
1010001111N001001
10100000100001111
10101111100001001
10001000000000001
11111111111111111